0000000000000000000
0000000000000000000
0000000000000000000
0000000000000000000
0000000000000000000
0000000000000444000
0000000000000434000
0000444444444424440
0444422242222422240
0422222222222422240
0444222222222222240
0004444222444444440
0000004444400000000
0000000000000000000
0000000000000000000
2 9