0000000000000000000
0000000000000000000
0000000000000000000
0000000000000000000
0044400000000444000
0042400000000434000
0042444440000424000
0042442244444424000
0042222222222224000
0042244442244224000
0044440044444444000
0000000000000000000
0000000000000000000
0000000000000000000
0000000000000000000
3 5
