0000000000000000000
0000000000000000000
0000000000000000000
0000000000000000000
0000000000000000000
0000000000000444000
0000000000000424000
0004444444444424440
0444222222222222240
0432222222222222240
0444422222222222240
0000444444444444440
0000000000000000000
0000000000000000000
0000000000000000000
14 6