0000000000000000000
0444444444444444400
0422222222222222440
0424444252222225240
0425222222222222240
0425444442444424440
0425444443422424000
0425444444422424000
0422444422222424000
0422255224442444000
0424222224442400000
0422244422222400000
0444440444444400000
0000000000000000000
0000000000000000000
14 8