0000000000000000000
4444400044444000000
4222444442224000000
4242442442424000000
4225225225224444000
4442442442444434000
0442442442444424000
0422225225224224400
0422242442424222400
0422222442224422400
0422444444444422400
0442222222222222400
0444444444444444400
0000000000000000000
0000000000000000000
6 3