0000000000000000000
0000000000000000000
0000000000000000000
0000000000000000000
0000000000000000000
0000000000000000000
0000000000000000000
0044444444444444400
0043222222222222400
0044444444444444400
0000000000000000000
0000000000000000000
0000000000000000000
0000000000000000000
0000000000000000000
15 8