0000000000000000000
0000000000000000000
0000000000000000000
0444440000004444400
0422244444444222400
0422244222244222400
0442222222222224400
0042444422444424000
0042404222240424000
0042404222240434000
0044404444440444000
0000000000000000000
0000000000000000000
0000000000000000000
0000000000000000000
3 9