0000000000000000000
0000000000000000000
0444444444444444000
0422222222222224000
0424444444444424444
0424443222222252224
0424444444444424424
0424444444444424424
0424444444444444424
0424444224422224424
0422222222222222224
0444442222224444444
0000044444444000000
0000000000000000000
0000000000000000000
14 7